ز=>ز
ظ=>ظ
ي=>ي
ى=>ي
ئ=>ى
خ=>خ
و=>و
ؤ=>و
ث=>ث
ت=>ت
ط=>ط
س=>س
ص=>ص
ر=>ر
ق=>ق
ن=>ن
م=>م
ل=>ل
ك=>ك
ج=>ج
ح=>ح
ة=>ه
ه=>ه
غ=>غ
ف=>ف
ع=>ع
د=>د
ض=>ض
ب=>ب
ا=>ا
أ=>ا
ٱ=>ا
إ=>ا
ش=>ش
ذ=>ذ
ء=>ء
َ=>
ُ=>
ِ=>
ْ=>
ّ=>
ٰ=>
ً=>
ٍ=>
ٌ=>
ٓ=>
ۢ=>
ٔ=>
ـ=>
۟=>
ۭ=>
ۦ=>
ۥ=>
۠=>
ۜ=>
۪=>
ۣ=>
ۨ=>
۬=>
۫=>
